# apt命令
alias suoyin='apt update'
alias shengji='apt upgrade'
alias shengjifull='apt full-upgrade'
alias shengjidist='apt dist-upgrade'
alias zhao='apt search' 
alias anzhuang='apt install'
alias kanruanjian='apt show'
alias shanchu='apt purge'
alias qingcan='apt autoremove'
alias qingli='apt clean && apt autoclean'
# systemd
alias yunxu='systemctl enable'
alias jinzhi='systemctl disable'
alias kaiqi='systemctl start'
alias tingzhi='systemctl stop'
alias zhuangtai='systemctl status'
# nala命令
alias nkuai='nala fetch'   
alias nsuoyin='nala update'  
alias nshengji='nala upgrade'
alias nzhao='nala search'  
alias nanzhuang='nala install'
alias nkanruanjian='nala show' 
alias nshanchu='nala purge'    
alias nqingcan='nala autopurge'
alias nqingli='nala clean'
# 其他
alias c='clear'
alias rm='rm -i'
alias cp='cp -i'
alias mv='mv -i'
alias shuaxinbash='source ~/.bashrc'
alias ll='ls -Flh --color=auto'
alias lianwang='ifconfig enp3s0 up'
alias duanwang='ifconfig enp3s0 down'
# docker
alias kaidocker='systemctl start docker'
alias guandocker='systemctl stop docker'
